_here	here	hes
a	an	ad	ano
able	abil	ible
al	ial
analog	analogue
ance	ence
ann	enn
ant	ent
celer	celero
co	con	com
dexter	dextr
duct	duc
en	em
geni	genu
im	in	ir
in	im
inter	enter
ious	ous
lexic	lex
line	lign
magnet	magneto
marshall	marshal
medic	medico
meter	metr
money	moni
myth	mytho
particle	particul
patho	path
phys	physio
quire	quis
rect	recto
script	scrib
sorb	sorp
space	spati
tableau	tableaux
thermo	therm
vertex	vertic
